R 1000 10000
NO ./textures/wall_north.xpm
SO ./textures/wa_s.xpm
WE ./textures/wall_west.xpm
EA ./textures/wae.xpm
S ./textures/sprite1.xpm
ST ./textures/wood_ceil.xpm
FT ./textures/floor_text.xpm
F 1,0,0
C 211,123,123

111111111
1S0000001
120000001
111111111