R 242 12324
NO ./textures/wall_north.xpm
SO ./textures/wa_s.xpm
WE ./textures/wall_west.xpm
EA ./textures/wae.xpm
S ./textures/amongus.xpm
FT ./textures/floor_text.xpm
ST ./textures/wood_ceil.xpm
F 1,123,342
C 211,123,123

111111111
100000001
100001101
100000001
100000001
100000001
100000001
100020001
100000001
101000001
100000001
100000001
101000001
1000N0001
100000001
111111111