R 848 480
NO ./textures/north.xpm
SO ./textures/south.xpm
WE ./textures/west.xpm
EA ./textures/east.xpm
S ./textures/sprite.xpm
F 184,113,39
C 211,123,123

        1111111111111111111111111
        1000000000000000000000001
        1100000000000000000000001
        1011100000000000011100001
111111111000000000000000100000001
100000000000000000000001110001111
10000111110000N10000000110001
10000000000000000011110000001
10001111000000001111110000001
10000000000000000001111100001
10000111110000000001010000001
11000001110101011111011110101
11110111 1010121 101111010001
11111111 1111111 111111111111