R 848 480
NO ./textures/north.xpm
SO ./textures/south.xpm
WE ./textures/west.xpm
EA ./textures/east.xpm
S ./textures/sprite.xpm
ST ./textures/ceil.xpm
FT ./textures/floor.xpm
F 184,113,39

1111111
100N001
1111111