R 848 480
NO ./textures/north.xpm
SO ./textures/south.xpm
WE ./textures/west.xpm
EA ./textures/east.xpm
S ./textures/sprite.xpm
ST ./textures/ceil.xpm
FT ./textures/floor.xpm
F 184,113,39

111111111111
100000000001
1100N0200011
110000200011
111111111111